             
 C . . . . . 
             
S. . . . . . 
           - 
 . .|. . . . 
 - -     -   
 . . . H . . 
 =       -   
 . . . . . . 
       -     
 . M . . . . 
             